All trademarks and copyrights affiliated to these sprites are owned by
their respective trademark and copyright holders. I am in no way
affiliated with Squaresoft, Enix, Square-Enix, Capcom, DeNA, Nintendo or any gaming company.


Big thanks to Abyssonym, Subtraction Soup, Myself086, Cecil188, Greenknight5 and anyone else who has contributed to the development of Final Fantasy 6 Beyond Chaos.


Thanks to all the BC community especially Quikdraw7777, Graffin226, Zekelas, Muppetsinspace, Kup0p, CjrynnChere, Bluzhu, Desruprot, Phyzers, Couch_23, SartheBazaar, Darkslash88, and many others for their play testing, advice, inspiration, and friendship.





special thanks to the entire FF6Hacking.com sprite community for all their work on FF6 sprites:
Madsiur, Gi Nattak, Ameratsu, Arodrick, Astaroth, B1llygo4t, Badass, Brun, Bryan120608, Christian, crumpledmedal, Cyprus, Djinn, Dr Blank, Druidx, Eddielee, Feok, FF6fanatic, fffanatic, fnrrfygmschnish, foxhoundmember9999, Funkydiscogod, gilgamesh, jameswhite89, jcollins, junjinka, koreki, kugawattan, loneredmage, manakaiser, matthew50, metroidquest, mickichiba, onereaver, philaharmic, Poco Loco, rjenyawd, royaken, sapprentice, sathka, scarabenigma, silvermaine, sutebenukun, thorieboy, timbo, tinman, turbotastic, unklmnky, vyperbyte, wolfokami321, xeblon, xolardark, zeemis, and zozma.





Individual credits:

Astaroth: Edea-Kramer, Cloud-Darkness, Rosa, Atma, Opera Celes, Aerith, Elena, Rude, Tifa, Yuna, Vaan, Fang, Hope, Lightning, Sazh, Snow, Vanille, Lenneth

Badass: Granny, Ryu, Cat, Chrono, Cyrus, Frog, Robo, Slash, Mr Saturn, Berserker, Gaffgarion, Bowser, Mario, Yoshi, Megaman X, Samus Suit, Samus Zero, Bubble Dragon, Duran, SoE Boy, Sonic, Ness, cat portrait, robo portrait, slash portrait, sonic portrait,

Christian: Tifa

crumpledmedal: Ayla, dog hunter

Dr Blank: Elite Knight, Faris

Eddielee: heartless

Feok: Lucca, Magus, Onionknight, FuSoYa, Golbez, Palom, Porom, Rosa, Rydia, Tellah, katarin, vincent, yuffie, steiner, lightning, vanille, Link

FFfanatic: Cid

fnrrfygmschnish: heartless

Funkydiscogod: batman

jameswhite89: johnny, boco, zok, bird, bomb, merchant, black mage, blue mage, grenade, mini, hunter, timemage, tonberry, baby, fish, goku, flea, vader, berserker portrait, link portrait, bird portrait, bowser portrait, fish portrait, flea portrait, interceptor portrait, returner portrait, squall portrait, ultros portrait

junjinka: zidane

kugawattan: mr saturn, bartz, gilgamesh, borghen, bandit, archer, bartz portrait

matthew50: whitemage

metroidquest: dark cecil, frog, gestahl, kain, paladin cecil, cecil amano, magus, black mage portrait, dark cecil portrait, frog portrait, kain portrait, paladin cecil portrait

mickichiba: ryu, dark cecil, tay cecil, adult relm, aeria, sephiroth, pikachu

one reaver: gabranth, garland

Poco Loco: Rosa, Arvis, Baram, chupon, clyde, cultist, dancer, daryl, dion, draco, dragon, fairy, figaro guard, gestahl, lone wolf, maduin, narshe guard, rachel, returner, scholar, siegfried, thief, ultros, vargas, laguna, squall, beatrix, eiko, kuja, vivi, tidus, draco portrait, siegfried portrait

rjenyawd: Tiny moogle

royaken: cloud

sapprentice: Yang, interceptor

silvermaine: Orlandu

sutebenukun: tellah, aerith, sephiroth, garnet, quina, dancer, edward portrait, rydia portrait, white mage portrait

tinman: gilgamesh

unklmnky: gilgamesh

wolfokami321: cloud, sora

xeblon: seifer, beatrix portrait, reno portrait, seifer portrait

xolardark: pig

zeemis: golbez, kain, rydia, red mage

zozma: edward, rydia, boy, chancellor, granny, katarin, lady, Opera Celes, Rachel, Gau Suit, Train Conductor, and vargas. 

unknown credit goes out to - dragoon, potato, peach, cloud portrait, daryl portrait

CtrlxZ - Curation, Compilation, Editting, and BC preparation as well as Ramza, Reno, Seifer, Squall, Chupon, Retro Pikachu, Bartz, Kelgar, Edge, Holy Dragoon, Sephiroth

Bluzhu: Retro Link, Buu, Dogstahl

and YOU!